NO ./textures/wall_north.xpm
SO ./textures/wall_south.xpm
WE ./textures/wall_west.xpm
EA ./textures/wall_east.xpm


F 120,236,14
C 254,65,98

1111111111
1111000001
1000N00001
1011111101
1000000001
1111111111
