NO ./textures/wall_north.xpm
SO ./textures/wall_south.xpm
WE ./textures/wall_west.xpm
EA ./textures/wall_east.xpm

C 128,128,128
F 135,206,250

1111111111
1111000001
1000N00001
1011111101
1000000001
1111111111